121111111111
141111111111
141111111111
141111111111
141111111111
141111111111
141111111111
141111111111
141111111111
141111111111
144444444431
111111111111