121111111111
144444444441
111111111141
144444444441
141111111111
144444444441
111111111141
144444444441
141111111111
144444444441
111111111131
111111111111