121111111111
144444444441
111111111141
144444444441
141111111111
144444444441
111111111141
144444444441
141111111111
144444111111
111113111111
111111111111